NO	./Textures/NO.xpm
  
					      
  SO			./Textures/SO.xpm
  
	    EA				./Textures/EA.xpm
                       
					WE         ./Textures/WE.xpm

F	0,39,47

		C 245,245,220









1111111111111
1001001001001
1000000000001
100100000100111111111111111111111111111111111111
100000000000000000000000000000000000000000011111
111111011111111111111111100001111111111111111111
    10001               100001111111111111111111
    10001               100000000000000000000001
    10N01               100000000000000000000001
    11111               100000000000000000000001
	                    100000000000000000000001
						100000000000000000000001
						100000000000000000000001
						111111111111111111111111

