111111111111111111111111111111
1P00000000000N0000000000000011
111111100C00000000000011111E11
100C000000011111100000000C1111
1001110101000C1111111111111111
111111010111111N0000000N1000C1
11C00001000000000N1N0000001111
1N1111000111011111110111111111
1C00000111110111N0000011111111
1N1111111100011111100000000C11
11C00000000N111CN0001111111111
1C111111011111100011000N0C1111
100N11110111111101110N0N0N1111
1N0000000000000000000N000N1111
111111111111111111111111111111