111111111111111111111111111111
1E000N000110000000N00000000011
100N000N0000111110011111110001
111111111111000001000001100101
111111111100001111111100001101
1111111110010000000111N0001101
1C011111001N000000000000001101
10N111100100000P0000110N0N1101
10000000100N100000011100NC1101
1N0N1111100CN11N111111N0N01101
100011111011C00000N0000000N101
10001111NNN1011111111111111101
10C011111111011111111111111101
10000000000000N0000000000000C1
111111111111111111111111111111
